############
#..--#-----###
#..--#-$--$--#
#..--#$####--#
#..----@-##--#
#..--#-#--$-##
######-##$-$-#
--#-$--$-$-$-#
--#----#-----#
--############
Title: Level 2
Author: ThinkingRabbit (1988), from https://sokoban.dk