########
#      #
#@   $ #
#   #  #
# .    #
########
Title: Level 0
Author: JoAn